GLT = "countries/Glytter.txt"
EST = "countries/Estmere.txt"
FLO = "countries/Florena.txt"
GAL = "countries/Gaullica.txt"
FOA = "countries/Federation.txt"
NEG = "countries/Negara.txt"
WER = "countries/Werania.txt"
VRE = "countries/Vredlandia.txt"
HEN = "countries/Hennehouwe.txt"
ETR = "countries/Etruria.txt"
BUC = "countries/Buckland.txt"
AZM = "countries/Azmara.txt"
NOR = "countries/Norday.txt"
KES = "countries/Kesselbourg.txt"
AQU = "countries/Aquila.txt"
MAR = "countries/Marolevia.txt"
LIN = "countries/Linallia.txt"
ART = "countries/Artis.txt"
ESV = "countries/Estivan.txt"
AMA = "countries/Amathia.txt"
RHA = "countries/Rhakhataa.txt"
XUO = "countries/Xuopriva.txt"
LUZ = "countries/Luzarra.txt"
RYL = "countries/Rylincia.txt"
AUZ = "countries/Autonomous Zone.txt"
HUS = "countries/Husiland.txt"
KAS = "countries/Kasia.txt"
BOL = "countries/Bolsha Republic.txt"
JOS = "countries/Jostova.txt"
UST = "countries/Ustowanie.txt"
SIP = "countries/Siphelia.txt"
HWF = "countries/Hwffen.txt"
WAL = "countries/Waldeck.txt"
SAR = "countries/Sarenia.txt"
SON = "countries/Songguo.txt"
NEM = "countries/Nematsu.txt"
BER = "countries/Berseri Empire.txt"
CEL = "countries/Celestial Isles.txt"
NIM = "countries/Nimear.txt"
SAT = "countries/Satucin.txt"
MRI = "countries/Marirana.txt"
MSE = "countries/Mathra States.txt"
EHY = "countries/Estmerish Hyndana.txt"
EIS = "countries/Eisenkuste.txt"
VIL = "countries/Vilcasuamanas.txt"
SLU = "countries/San Luca.txt"
LUM = "countries/Luminika.txt"
ALA = "countries/Alagarve.txt"
PLT = "countries/Platerdam.txt"
VAL = "countries/Valentir.txt"
DUQ = "countries/Duquesne.txt"
ROE = "countries/Roeselle.txt"
MOR = "countries/Moreira.txt"
SEN = "countries/Senouillac.txt"
ZIM = "countries/Zimte.txt"
MEI = "countries/Meidao.txt"
SAN = "countries/Santcuary.txt"
NOV = "countries/Novostask.txt"
MON = "countries/Montbrio.txt"
ALB = "countries/Alto Barrasso.txt"
COS = "countries/Costa Calda.txt"
ALT = "countries/Althira.txt"
DOR = "countries/Dorastan.txt"
JAR = "countries/Jaradpur.txt"
TEK = "countries/Tekaunga.txt"
JHA = "countries/Jhakira.txt"
PHU = "countries/Phula.txt"
KOE = "countries/Kingdom of Ezekiel.txt"
KHA = "countries/Khatagh.txt"
STA = "countries/Stan 1.txt"
STN = "countries/Stan 2.txt"
IHY = "countries/Independent Hyndic.txt"
 

FAR = "countries/Fars.txt"
GRW = "countries/Greater Werania.txt"
EUC = "countries/Euclea.txt"